---------------
--------------T
------------TTT
-----------TTTT
-----------TTTT
-----------TTTT
------------TTT
--------------T
---------------
---------------
---------------
---------------
---------------
---------------
---------------